li_PRT	PRT
fa_PRT	PRT
2mp_pron	PRO
PRT	PRT
2ms_pron	PRO
PNX	PNX
2fs_PRO	PRO
C	C
2ms_PRO	PRO
N	N
la_PRT	PRT
2mp_PRO	PRO
V	V
REL	REL
P	P
fa_C	C
PRO	PRO
3ms_pron	PRO
1s_PRO	PRO
3d_PRO	PRO
3ms_PRO	PRO
wa_prep	P
3fs_PRO	PRO
wa_C	C
AV	AV	
1p_PRO	PRO
3mp_PRO	PRO
1p_pron	PRO
1s_pron	PRO
PN	PN
AB	ABBREV
sa_PRT	PRT
3fs_pron	PRO
AJ	AJ
ma_PRO	PRO
ma_REL	REL
2d_PRO	PRO
2fp_pron	PRO
3fp_PRO	PRO
2fs_pron	PRO
