PREP	P
NOUN	N
PUNC	PNX
FUNC	N
ADV	AV
PART	PRT
DET	PRT
V	V
CONJ	C
REL	REL
FOREIGN	N
ADJ	AJ
ABBREV	ABBREV
PRON	PRO
NUM	N
NOUN_PROP	PN
adj	AJ
adj_comp	AJ
adj_num	N
noun	N
noun_num	N
noun_quant	N
noun_prop	PN
verb	V
verb_pseudo	V
pron_rel	REL
adv_rel	REL
part_restrict	PRT
prep	P
