ABBREV
ADJ
ADJ.VN	ADJ
ADJ_COMP	ADJ
ADJ_NUM	NUM
ADV
INTERROG_ADV	ADV
CASE
CASE_INDEF_ACC	CASE
CONJ
CV	V
CVSUFF	VSUFF
CVSUFF_DO:1S	PRON
CVSUFF_DO:3MS	PRON
CVSUFF_SUBJ:2MP	VSUFF
CVSUFF_SUBJ:2MS	VSUFF
CVSUFF_DO:3MP	PRON
CVSUFF_DO:1P	PRON
CVSUFF_DO:3FS	PRON
CVSUFF_DO:3D	PRON
CVSUFF_DO:3FP	PRON
CVSUFF_SUBJ:2FS	VSUFF
DEM_PRON_FD	PRON
DEM_PRON_FS	PRON
DEM_PRON_MD	PRON
DEM_PRON_MP	PRON
DEM_PRON_MS	PRON
DEM_PRON	PRON
DEM_PRON_F	PRON
DEM_PRON_P	PRON
DET
FOREIGN
INTERJ
IV	V
IV1P	V
IV1S	V
IV2D	V
IV2FP	V
IV2FS	V
IV2MP	V
IV2MS	V
IV3FD	V
IV3FP	V
IV3FS	V
IV3MD	V
IV3MP	V
IV3MS	V
IVSUFF_DO:1P	PRON
IVSUFF_DO:1S	PRON
IVSUFF_DO:2FS	PRON
IVSUFF_DO:2D	PRON
IVSUFF_DO:2MP	PRON
IVSUFF_DO:2MS	PRON
IVSUFF_DO:3D	PRON
IVSUFF_DO:3FS	PRON
IVSUFF_DO:3MP	PRON
IVSUFF_DO:3MS	PRON
IVSUFF_DO:2FP	PRON
IVSUFF_DO:3FP	PRON
IVSUFF_MOOD	VSUFF
IVSUFF_SUBJ:2FS	VSUFF
IVSUFF_SUBJ:D	VSUFF
IVSUFF_SUBJ:FP	VSUFF
IVSUFF_SUBJ:MP	VSUFF
PVSUFF_SUBJ:2FP	VSUFF
IVSUFF_SUBJ:3FP	VSUFF
IVSUFF_SUBJ:3D	VSUFF
IVSUFF_MOOD:I	VSUFF
IVSUFF_MOOD:J	VSUFF
IVSUFF_MOOD:S	VSUFF
IVSUFF_SUBJ:2FS_MOOD:I	VSUFF
IVSUFF_SUBJ:D_MOOD:I	VSUFF
IVSUFF_SUBJ:D_MOOD:SJ	VSUFF
IVSUFF_SUBJ:MP_MOOD:I	VSUFF
IVSUFF_SUBJ:MP_MOOD:SJ	VSUFF
IVSUFF_SUBJ:2FS_MOOD:SJ	VSUFF
IVSUFF_SUBJ:3MP_MOOD:SJ	VSUFF
IV_PASS	V
LATIN	FOREIGN
NEG_PART	PART
NOUN
NOUN_PROP	NOUN_PROP
NOUN_NUM	NUM
NOUN_QUANT	NOUN
NOUN.VN	NOUN
NSUFF_FEM_DU	NSUFF
NSUFF_FEM_PL	NSUFF
NSUFF_FEM_SG	NSUFF
NSUFF_MASC_DU	NSUFF
NSUFF_MASC_PL	NSUFF
NSUFF_FEM_DU_ACC	NSUFF
NSUFF_FEM_DU_ACC_POSS	NSUFF
NSUFF_FEM_DU_GEN	NSUFF
NSUFF_FEM_DU_GEN_POSS	NSUFF
NSUFF_FEM_DU_NOM	NSUFF
NSUFF_FEM_DU_NOM_POSS	NSUFF
NSUFF_MASC_DU_ACC	NSUFF
NSUFF_MASC_DU_ACC_POSS	NSUFF
NSUFF_MASC_DU_GEN	NSUFF
NSUFF_MASC_DU_GEN_POSS	NSUFF
NSUFF_MASC_DU_NOM	NSUFF
NSUFF_MASC_DU_NOM_POSS	NSUFF
NSUFF_MASC_PL_ACC	NSUFF
NSUFF_MASC_PL_ACC_POSS	NSUFF
NSUFF_MASC_PL_GEN	NSUFF
NSUFF_MASC_PL_GEN_POSS	NSUFF
NSUFF_MASC_PL_NOM	NSUFF
NSUFF_MASC_PL_NOM_POSS	NSUFF
NUM
O
PART
FUT	PART
CONNEC_PART	PART
FOCUS_PART	PART
RESTRIC_PART	PART
EMPHATIC_PART	PART
PSEUDO_VERB	V
VOC_PART	PART
INTERROG_PART	PART
INTERROG_PRON	PART
INTERJ	PART
JUS_PART	PART
EMPH_PART	PART
EXCEPT_PART	PART
POSS_PRON_1P	PRON
POSS_PRON_1S	PRON
POSS_PRON_2FP	PRON
POSS_PRON_2FS	PRON
POSS_PRON_2MP	PRON
POSS_PRON_2MS	PRON
POSS_PRON_3D	PRON
POSS_PRON_3FP	PRON
POSS_PRON_3FS	PRON
POSS_PRON_3MP	PRON
POSS_PRON_3MS	PRON
POSS_PRON_2D	PRON
PREP
PRON
PRON_1P	PRON
PRON_1S	PRON
PRON_2D	PRON
PRON_2FP	PRON
PRON_2FS	PRON
PRON_2MP	PRON
PRON_2MS	PRON
PRON_3D	PRON
PRON_3FP	PRON
PRON_3FS	PRON
PRON_3MP	PRON
PRON_3MS	PRON
EXCLAM_PRON	PRON
PUNC
PV	V
PVSUFF_DO:1P	PRON
PVSUFF_DO:1S	PRON
PVSUFF_DO:2MP	PRON
PVSUFF_DO:2MS	PRON
PVSUFF_DO:3D	PRON
PVSUFF_DO:2D	PRON
PVSUFF_DO:3FS	PRON
PVSUFF_DO:3MP	PRON
PVSUFF_DO:3MS	PRON
PVSUFF_DO:2FS	PRON
PVSUFF_DO:2FP	PRON
PVSUFF_DO:3FP	PRON
PVSUFF_SUBJ:1P	VSUFF
PVSUFF_SUBJ:1S	VSUFF
PVSUFF_SUBJ:2FS	VSUFF
PVSUFF_SUBJ:2MP	VSUFF
PVSUFF_SUBJ:2MS	VSUFF
PVSUFF_SUBJ:3FD	VSUFF
PVSUFF_SUBJ:3FP	VSUFF
PVSUFF_SUBJ:3FS	VSUFF
PVSUFF_SUBJ:3MD	VSUFF
PVSUFF_SUBJ:3MP	VSUFF
PVSUFF_SUBJ:3MS	VSUFF
PVSUFF_SUBJ:2D	VSUFF
PV_PASS	V
NUMERIC_COMMA	PUNC
RC_PART	PART
REL_ADV	REL
REL_PRON	REL
SUB_CONJ	CONJ
VERB_PART	PART
TYPO	FOREIGN
DIALECT	FOREIGN
FUT_PART	PART
VERB	V
NO_FUNC	NOUN
DEM	NOUN
JUS	JUS
FUNC_WORD	FUNC
